":START_ID",":END_ID"
"366","371"
"366","379"
"366","386"
"366","395"
"366","401"
"366","404"
"366","431"
"366","437"
"366","441"
"366","685"
"366","687"
"366","695"
"366","697"
"366","702"
"366","707"
"366","876"
"366","893"
"366","899"
"366","1012"
"366","1016"
"366","1021"
"366","1025"
"366","1029"
"366","1073"
"366","1077"
"366","1083"
"366","1096"
"366","1119"
"366","1128"
"366","1143"
"366","1157"
"366","1162"
"367","1252"
"367","1260"
"367","1267"
"367","1276"
"367","1282"
"367","1285"
"367","1312"
"367","1318"
"367","1322"
"367","1566"
"367","1568"
"367","1576"
"367","1578"
"367","1583"
"367","1752"
"367","1769"
"367","1775"
"367","1888"
"367","1892"
"367","1897"
"367","1901"
"367","1905"
"367","1949"
"367","1953"
"367","1959"
"367","1972"
"367","1995"
"367","2018"
"367","2027"
"367","2042"
"367","2056"
"367","2070"
"367","2075"
"367","2165"
"368","2255"
"368","2263"
"368","2270"
"368","2279"
"368","2285"
"368","2288"
"368","2315"
"368","2321"
"368","2325"
"368","2569"
"368","2571"
"368","2579"
"368","2581"
"368","2586"
"368","2755"
"368","2772"
"368","2778"
"368","2891"
"368","2895"
"368","2900"
"368","2904"
"368","2908"
"368","2952"
"368","2956"
"368","2962"
"368","2975"
"368","2998"
"368","3021"
"368","3030"
"368","3045"
"368","3059"
"368","3073"
"368","3078"
"368","3168"
"369","3258"
"369","3266"
"369","3273"
"369","3282"
"369","3288"
"369","3291"
"369","3318"
"369","3324"
"369","3328"
"369","3572"
"369","3574"
"369","3582"
"369","3584"
"369","3589"
"369","3758"
"369","3775"
"369","3781"
"369","3894"
"369","3898"
"369","3903"
"369","3907"
"369","3911"
"369","3955"
"369","3959"
"369","3965"
"369","3978"
"369","4001"
"369","4024"
"369","4033"
"369","4048"
"369","4062"
"369","4076"
"369","4081"
"369","4171"
"370","4261"
"370","4269"
"370","4276"
"370","4285"
"370","4291"
"370","4294"
"370","4321"
"370","4327"
"370","4331"
"370","4575"
"370","4577"
"370","4585"
"370","4587"
"370","4592"
"370","4761"
"370","4778"
"370","4784"
"370","4897"
"370","4901"
"370","4906"
"370","4910"
"370","4914"
"370","4958"
"370","4962"
"370","4968"
"370","4981"
"370","5004"
"370","5027"
"370","5036"
"370","5051"
"370","5065"
"370","5079"
"370","5084"
"370","5174"
