":START_ID",":END_ID"
"364","369"
"364","377"
"364","384"
"364","393"
"364","399"
"364","402"
"364","429"
"364","435"
"364","439"
"364","683"
"364","685"
"364","693"
"364","695"
"364","700"
"364","705"
"364","874"
"364","891"
"364","897"
"364","1010"
"364","1014"
"364","1019"
"364","1023"
"364","1027"
"364","1071"
"364","1075"
"364","1081"
"364","1094"
"364","1117"
"364","1126"
"364","1141"
"364","1155"
"364","1160"
"365","1250"
"365","1258"
"365","1265"
"365","1274"
"365","1280"
"365","1283"
"365","1310"
"365","1316"
"365","1320"
"365","1564"
"365","1566"
"365","1574"
"365","1576"
"365","1581"
"365","1750"
"365","1767"
"365","1773"
"365","1886"
"365","1890"
"365","1895"
"365","1899"
"365","1903"
"365","1947"
"365","1951"
"365","1957"
"365","1970"
"365","1993"
"365","2016"
"365","2025"
"365","2040"
"365","2054"
"365","2068"
"365","2073"
"365","2163"
"366","2253"
"366","2261"
"366","2268"
"366","2277"
"366","2283"
"366","2286"
"366","2313"
"366","2319"
"366","2323"
"366","2567"
"366","2569"
"366","2577"
"366","2579"
"366","2584"
"366","2753"
"366","2770"
"366","2776"
"366","2889"
"366","2893"
"366","2898"
"366","2902"
"366","2906"
"366","2950"
"366","2954"
"366","2960"
"366","2973"
"366","2996"
"366","3019"
"366","3028"
"366","3043"
"366","3057"
"366","3071"
"366","3076"
"366","3166"
"367","3256"
"367","3264"
"367","3271"
"367","3280"
"367","3286"
"367","3289"
"367","3316"
"367","3322"
"367","3326"
"367","3570"
"367","3572"
"367","3580"
"367","3582"
"367","3587"
"367","3756"
"367","3773"
"367","3779"
"367","3892"
"367","3896"
"367","3901"
"367","3905"
"367","3909"
"367","3953"
"367","3957"
"367","3963"
"367","3976"
"367","3999"
"367","4022"
"367","4031"
"367","4046"
"367","4060"
"367","4074"
"367","4079"
"367","4169"
"368","4259"
"368","4267"
"368","4274"
"368","4283"
"368","4289"
"368","4292"
"368","4319"
"368","4325"
"368","4329"
"368","4573"
"368","4575"
"368","4583"
"368","4585"
"368","4590"
"368","4759"
"368","4776"
"368","4782"
"368","4895"
"368","4899"
"368","4904"
"368","4908"
"368","4912"
"368","4956"
"368","4960"
"368","4966"
"368","4979"
"368","5002"
"368","5025"
"368","5034"
"368","5049"
"368","5063"
"368","5077"
"368","5082"
"368","5172"
